PRO	ANA	entity/type
DEF	ANA	type
HAS	ANA	relation
REF	ANA	entity/type
EMP	ANA	entity/type
GRE	ACT	none
ITJ	ACT	none
HES	ACT	none
QUE	ACT	none
QUC	ATT	none
QUV	ATT	none
COL	ATT	none
IST	ATT	none
SST	ATT	none
PRI	ATT	relation/none
DEG	ATT	none
INT	ATT	none
REL	ATT	relation/none
SCO	ATT	none
EQU	COM	relation/none
MOR	COM	none
LES	COM	none
TOP	COM	none
BOT	COM	none
ORD	COM	none
CON	UNE	type
ROL	UNE	type
GRP	UNE	type
DXP	DXS	none
DXT	DXS	none
DXD	DXS	none
ALT	LOG	none
XCL	LOG	none
NIL	LOG	none
DIS	LOG	none
IMP	LOG	none
AND	LOG	none
NOT	MOD	none
NEC	MOD	none
POS	MOD	none
SUB	DSC	none
COO	DSC	none
APP	DSC	none
BUT	DSC	none
PER	NAM	entity
GPE	NAM	entity
GPO	NAM	entity
GEO	NAM	entity
ORG	NAM	entity
ART	NAM	entity
HAP	NAM	entity
UOM	NAM	entity
CTC	NAM	entity
URL	NAM	entity
LIT	NAM	entity
NTH	NAM	entity
EXS	EVE	relation/none
ENS	EVE	relation/none
EPS	EVE	relation/none
EXG	EVE	relation/none
EXT	EVE	relation/none
NOW	TNS	none
PST	TNS	none
FUT	TNS	none
PRG	TNS	none
PFT	TNS	none
DAT	TIM	entity
DOM	TIM	entity
YOC	TIM	entity
DOW	TIM	entity
MOY	TIM	entity
DEC	TIM	entity
CLO	TIM	entity
